  
{"matrix": [
[-1, 3, -1, -1, -1, -1, 1, 6, -1],
[-1, 1, -1, 2, -1, -1, 5, -1, -1], 
[-1, -1, -1, -1, 3, -1, -1, -1, -1], 
[7, -1, -1, -1, -1, -1, -1, 5, -1],
[8, -1, 11, 9, 4, 11, 2, 6, -1], 
[-1, -1, -1, -1, -1, -1, -1, -1, -1],
[-1, -1, 7, -1, -1, -1, 9, 10, -1], 
[10, 8, -1, -1, -1, -1, -1, -1, -1], 
[-1, -1, -1, 4, -1, -1, -1, -1, -1]
]}