  
{"matrix": [
[2, -1, -1, -1, -1, -1, -1, -1, -1, -1],
[-1, -1, 1, -1, -1, -1, -1, -1, -1, -1], 
[-1, -1, -1, 3, 2, -1, -1, 5, -1, -1], 
[-1, -1, -1, -1, -1, -1, -1, -1, -1, -1],
[-1, -1, -1, -1, -1, -1, -1, 3, -1, -1], 
[-1, 8, 9, 6, 7, -1, -1, -1, 1, 4],
[-1, -1, -1, -1, -1, -1, -1, -1, -1, -1],
[-1, -1, -1, 9, -1, -1, -1, -1, -1, -1],
[-1, -1, -1, -1, -1, 8, 4, 6, 5, -1],
[-1, -1, -1, -1, -1, 7, -1, -1, -1, -1]
]}